  ##### 
###   # 
# B # ##
# #  I #
#    # #
##B#I  #
 #P  ###
 #####  