    ####
#####  #
#   I  #
#  B#  #
## ## ##
#      #
# P#   #
#  #####
####    