  ##### 
###   # 
# B # ##
# #  I #
#    # #
## #   #
 #P  ###
 #####  
