    ####
#####  #
#   V  #
# VB#  #
## ## ##
# I    #
# P#   #
#  #####
####    