    ####
#####  #
#   B  #
# VI#  #
## ## ##
#      #
# P#   #
#  #####
####    