 #####  
 #   #  
##I# ###
#  BIP #
# #  # #
# #BBI #
#   ####
#####   