 #####  
 #   ## 
## #I ##
# I    #
#B B#  #
### P ##
  # # # 
  #   # 
  ##### 