 #####  
 #   #  
##I# ###
#   IP #
# #  # #
# #B B #
#   ####
#####   