 #####  
 #   ## 
##B#I ##
# I    #
#B B#I #
### P ##
  # # # 
  #   # 
  ##### 