  ##### 
###   # 
# I # ##
# #  B #
# B  # #
##I#BI #
 #P  ###
 #####  